7
5
#######
#---*+#
#H* *-#
#+-+--#
#######
